"filename", "language", "Python", "CSV", "TypeScript JSX", "XML", "JSON", "comment", "blank", "total"
"c:\Users\nohan\Desktop\Projects\Original\Tower Defense\data\config\entities.json", "JSON", 0, 0, 0, 0, 5, 0, 0, 5
"c:\Users\nohan\Desktop\Projects\Original\Tower Defense\data\config\hitboxes.json", "JSON", 0, 0, 0, 0, 4, 0, 0, 4
"c:\Users\nohan\Desktop\Projects\Original\Tower Defense\data\config\input.json", "JSON", 0, 0, 0, 0, 40, 0, 0, 40
"c:\Users\nohan\Desktop\Projects\Original\Tower Defense\data\config\level_data.json", "JSON", 0, 0, 0, 0, -35, 0, 0, -35
"c:\Users\nohan\Desktop\Projects\Original\Tower Defense\data\config\obst_hitboxes.json", "JSON", 0, 0, 0, 0, 1, 0, 0, 1
"c:\Users\nohan\Desktop\Projects\Original\Tower Defense\data\config\projectiles.json", "JSON", 0, 0, 0, 0, 9, 0, 0, 9
"c:\Users\nohan\Desktop\Projects\Original\Tower Defense\data\config\towers.json", "JSON", 0, 0, 0, 0, 37, 0, -6, 31
"c:\Users\nohan\Desktop\Projects\Original\Tower Defense\data\graphics\animations\death_sparks\config.json", "JSON", 0, 0, 0, 0, 1, 0, 0, 1
"c:\Users\nohan\Desktop\Projects\Original\Tower Defense\data\graphics\animations\knight_walk_down\config.json", "JSON", 0, 0, 0, 0, 1, 0, 0, 1
"c:\Users\nohan\Desktop\Projects\Original\Tower Defense\data\graphics\animations\knight_walk_side\config.json", "JSON", 0, 0, 0, 0, 1, 0, 0, 1
"c:\Users\nohan\Desktop\Projects\Original\Tower Defense\data\graphics\animations\knight_walk_up\config.json", "JSON", 0, 0, 0, 0, 1, 0, 0, 1
"c:\Users\nohan\Desktop\Projects\Original\Tower Defense\data\graphics\animations\mega_slime_die_down\config.json", "JSON", 0, 0, 0, 0, 1, 0, 0, 1
"c:\Users\nohan\Desktop\Projects\Original\Tower Defense\data\graphics\animations\mega_slime_die_side\config.json", "JSON", 0, 0, 0, 0, 1, 0, 0, 1
"c:\Users\nohan\Desktop\Projects\Original\Tower Defense\data\graphics\animations\mega_slime_die_up\config.json", "JSON", 0, 0, 0, 0, 1, 0, 0, 1
"c:\Users\nohan\Desktop\Projects\Original\Tower Defense\data\graphics\animations\player_die_side\config.json", "JSON", 0, 0, 0, 0, 1, 0, 0, 1
"c:\Users\nohan\Desktop\Projects\Original\Tower Defense\data\graphics\animations\slime_die_down\config.json", "JSON", 0, 0, 0, 0, 1, 0, 0, 1
"c:\Users\nohan\Desktop\Projects\Original\Tower Defense\data\graphics\animations\slime_die_side\config.json", "JSON", 0, 0, 0, 0, 1, 0, 0, 1
"c:\Users\nohan\Desktop\Projects\Original\Tower Defense\data\graphics\animations\slime_die_up\config.json", "JSON", 0, 0, 0, 0, 1, 0, 0, 1
"c:\Users\nohan\Desktop\Projects\Original\Tower Defense\data\maps\Tiled Files\tutorial.tmx", "XML", 0, 0, 0, 313, 0, 0, 1, 314
"c:\Users\nohan\Desktop\Projects\Original\Tower Defense\data\maps\tutorial\collideables.tsx", "TypeScript JSX", 0, 0, 37, 0, 0, 0, 1, 38
"c:\Users\nohan\Desktop\Projects\Original\Tower Defense\data\maps\tutorial\decorations.tsx", "TypeScript JSX", 0, 0, 4, 0, 0, 0, 1, 5
"c:\Users\nohan\Desktop\Projects\Original\Tower Defense\data\maps\tutorial\ground.tsx", "TypeScript JSX", 0, 0, 4, 0, 0, 0, 1, 5
"c:\Users\nohan\Desktop\Projects\Original\Tower Defense\data\maps\tutorial\tutorial_Collideables.csv", "CSV", 0, 23, 0, 0, 0, 0, 1, 24
"c:\Users\nohan\Desktop\Projects\Original\Tower Defense\data\maps\tutorial\tutorial_Decorations.csv", "CSV", 0, 20, 0, 0, 0, 0, 1, 21
"c:\Users\nohan\Desktop\Projects\Original\Tower Defense\data\maps\tutorial\tutorial_Ground.csv", "CSV", 0, 19, 0, 0, 0, 0, 1, 20
"c:\Users\nohan\Desktop\Projects\Original\Tower Defense\data\maps\tutorial\tutorial_Path.csv", "CSV", 0, 5, 0, 0, 0, 0, 1, 6
"c:\Users\nohan\Desktop\Projects\Original\Tower Defense\game.py", "Python", 1, 0, 0, 0, 0, 4, 1, 6
"c:\Users\nohan\Desktop\Projects\Original\Tower Defense\scripts\assets.py", "Python", 6, 0, 0, 0, 0, 0, -1, 5
"c:\Users\nohan\Desktop\Projects\Original\Tower Defense\scripts\builder.py", "Python", -15, 0, 0, 0, 0, 0, -4, -19
"c:\Users\nohan\Desktop\Projects\Original\Tower Defense\scripts\builder_menu.py", "Python", 15, 0, 0, 0, 0, 0, 3, 18
"c:\Users\nohan\Desktop\Projects\Original\Tower Defense\scripts\camera.py", "Python", 20, 0, 0, 0, 0, 0, 2, 22
"c:\Users\nohan\Desktop\Projects\Original\Tower Defense\scripts\core_funcs.py", "Python", 14, 0, 0, 0, 0, 0, 3, 17
"c:\Users\nohan\Desktop\Projects\Original\Tower Defense\scripts\destruction_particles.py", "Python", -50, 0, 0, 0, 0, 0, -10, -60
"c:\Users\nohan\Desktop\Projects\Original\Tower Defense\scripts\entities.py", "Python", 11, 0, 0, 0, 0, 0, 2, 13
"c:\Users\nohan\Desktop\Projects\Original\Tower Defense\scripts\entity.py", "Python", 54, 0, 0, 0, 0, 8, 10, 72
"c:\Users\nohan\Desktop\Projects\Original\Tower Defense\scripts\entity_map.py", "Python", 2, 0, 0, 0, 0, 0, 0, 2
"c:\Users\nohan\Desktop\Projects\Original\Tower Defense\scripts\entity_objs\kingslime.py", "Python", 3, 0, 0, 0, 0, 0, 2, 5
"c:\Users\nohan\Desktop\Projects\Original\Tower Defense\scripts\entity_objs\knight.py", "Python", 18, 0, 0, 0, 0, 0, 4, 22
"c:\Users\nohan\Desktop\Projects\Original\Tower Defense\scripts\entity_objs\megaslime.py", "Python", 3, 0, 0, 0, 0, 0, 2, 5
"c:\Users\nohan\Desktop\Projects\Original\Tower Defense\scripts\entity_objs\player.py", "Python", 8, 0, 0, 0, 0, -3, -4, 1
"c:\Users\nohan\Desktop\Projects\Original\Tower Defense\scripts\entity_objs\slime.py", "Python", -23, 0, 0, 0, 0, 6, -1, -18
"c:\Users\nohan\Desktop\Projects\Original\Tower Defense\scripts\hitboxes.py", "Python", -1, 0, 0, 0, 0, 0, 0, -1
"c:\Users\nohan\Desktop\Projects\Original\Tower Defense\scripts\input.py", "Python", 9, 0, 0, 0, 0, 0, 2, 11
"c:\Users\nohan\Desktop\Projects\Original\Tower Defense\scripts\projectiles.py", "Python", -16, 0, 0, 0, 0, 0, -2, -18
"c:\Users\nohan\Desktop\Projects\Original\Tower Defense\scripts\renderer.py", "Python", 22, 0, 0, 0, 0, 6, 4, 32
"c:\Users\nohan\Desktop\Projects\Original\Tower Defense\scripts\skills.py", "Python", -15, 0, 0, 0, 0, -1, -2, -18
"c:\Users\nohan\Desktop\Projects\Original\Tower Defense\scripts\spawner.py", "Python", -2, 0, 0, 0, 0, 0, 3, 1
"c:\Users\nohan\Desktop\Projects\Original\Tower Defense\scripts\tower.py", "Python", 126, 0, 0, 0, 0, 0, 29, 155
"c:\Users\nohan\Desktop\Projects\Original\Tower Defense\scripts\tower_map.py", "Python", 12, 0, 0, 0, 0, 0, 1, 13
"c:\Users\nohan\Desktop\Projects\Original\Tower Defense\scripts\tower_objs\archer.py", "Python", 6, 0, 0, 0, 0, 0, 2, 8
"c:\Users\nohan\Desktop\Projects\Original\Tower Defense\scripts\tower_objs\bomber.py", "Python", 6, 0, 0, 0, 0, 0, 2, 8
"c:\Users\nohan\Desktop\Projects\Original\Tower Defense\scripts\tower_objs\cleric.py", "Python", 6, 0, 0, 0, 0, 0, 2, 8
"c:\Users\nohan\Desktop\Projects\Original\Tower Defense\scripts\tower_objs\phoenix.py", "Python", 6, 0, 0, 0, 0, 0, 2, 8
"c:\Users\nohan\Desktop\Projects\Original\Tower Defense\scripts\tower_objs\wizard_tower.py", "Python", 18, 0, 0, 0, 0, 0, 5, 23
"c:\Users\nohan\Desktop\Projects\Original\Tower Defense\scripts\towers.py", "Python", 29, 0, 0, 0, 0, 0, 8, 37
"c:\Users\nohan\Desktop\Projects\Original\Tower Defense\scripts\weapon.py", "Python", -1, 0, 0, 0, 0, 0, 0, -1
"c:\Users\nohan\Desktop\Projects\Original\Tower Defense\scripts\weapon_anim.py", "Python", -25, 0, 0, 0, 0, 0, -5, -30
"c:\Users\nohan\Desktop\Projects\Original\Tower Defense\scripts\window.py", "Python", 11, 0, 0, 0, 0, 0, 3, 14
"c:\Users\nohan\Desktop\Projects\Original\Tower Defense\scripts\world.py", "Python", 20, 0, 0, 0, 0, 7, 8, 35
"Total", "-", 278, 67, 45, 313, 72, 27, 73, 875